{
	"grid": [
		"2222222222222222",
		"2111111111111112",
		"2111111111111112",
		"2113333333333112",
		"2113111111113112",
		"2113111111113112",
		"2113114444113112",
		"2113114551113112",
		"2113114551113112",
		"2113114444443112",
		"2113111111111112",
		"2113111111111112",
		"2113333333333332",
		"2111111111111112",
		"2111111111111112",
		"2222222222222112",
		"................"
	],
	"legend":[
		{
			"character": "a",
			"effectName": "accelerate",
			"health": 1,
			"invulnerable": false
		}
	]
}